11111111111111111111111111111111111
1E0000000000010001000000000100000C1
11111111111100010001000010010000001
1C000000001111111111000010010000001
11111111100000000000000011110000001
10000000001111100000000000000000001
1011111111100000C000000011111111111
10000000001000000000011110000000001
11111111101000000000010000000001001
10000000001000000000010001111111001
10111111111111111111010001000000001
10000000000000000000010001000000001
1C0000000000000000000000010000000P1
11111111111111111111111111111111111