111111111
1E00C00P1
111111111