1111111111111
1E00000000001
1000C00000001
1000C00000001
1000C00000001
100000P000001
1111111111111