111111111111
1E000CC00011
100000000001








100100100001
100C00100P01
100000100001
111111111111