111111111111111111111111111
1000000C0000000000100000E01
100000C10000000100000000001
100001C10000010000000011001
100000110000111111111111111
10000000C00C000000001110001
10111C000000000000111C00001
10000000000C000111100000001
100C11100000000000000100001
10111000000000C000000C11001
11C0000C0000111000000000001
100000100010000000000000001
10000000000000C000000000001
1000P0000010000000000000001
111111111111111111111111111