111111
1CC0E1
10P001
1C0001
111111