11111111111111111111
10000000000000000001
10000000000000000001
10000000000000000001
10E000000P0000000001
10000000000000000001
1000000CCC0000000001
10000000000000000001
10000000000000000001
10000000000000000001
10000000000000000001
10000000000000000001
11111111111111111111