1111111111
1CC1E00001
10C1111001
1001P00001
100010C001
10100CC101
1111111111